#######################################################################################################################
#######################################################################################################################
######|—————————————————————————————————————|##########################################################################
######|·····································|##########################################################################
######|·····································|————————————————————————|#################################################
######|·····································\························|#################################################
######|·····································|———————————————————— ···|#################################################
######|·····································|####################|···|#################################################
######|·····································|####################|···|#################################################
######|—————————————————————————————————————|####################|···|#################################################
#######################################################################################################################
#######################################################################################################################
#######################################################################################################################